....................
S##############.....
..............#.....
............O.#.....
..............#.....
..............#.....
.......O..#####.....
..........#.........
..........#.........
..........#..O......
..........#.........
..........#########B
....................
..........O.........
....................
