....................
S##############.....
..............#.....
............O.#.....
.....O........#..O..
..............#.....
S####..O..#########B
....#.....#.........
....#.....#.........
....#.....#..O......
....#######.........
..........#########B
....................
..........O.........
....................
