....................
S######.....O.......
......#.............
S############.......
......#.....#.......
S######..O..#...O...
......#.....#.......
S##################B
......#.....#.......
S######..O..#...O...
......#.....#.......
S############.......
......#.............
S######.....O.......
....................