....................
S######.....O.......
......#.............
S##################B
......#.....#.......
S######..O..#...O...
......#.....#.......
S##################B
......#.....#.......
S######..O..#...O...
......#.....#.......
S##################B
......#.............
S######.....O.......
....................
