....................
S##################.
.#........#...#...#.
.#....O...#...#.O.#.
.#........#...#...#.
.#####..O.#.O.#####.
.#...#....#...#...#.
.#.O.##########.O.#.
.#...#....#...#...#.
.#####..O.#########.
.#........#.......#.
.#...O....#.O...O.#.
.#........#.......#.
.##################B
....................