....................
S##############.....
..............#.....
............O.#.....
.....O........#.....
..............#.....
S####.....#########B
....#.....#...O.....
....#.....#########B
....#.....#..O......
....#######.........
.......O............
....................
....................
....................
